adjbnnmnmbdmgohjopaebaaneclmihfm_1_3_7	.vks
biiammgklaefagjclmnlialkmaemifgo_2017_2_12_0	#idn5lihbleg6
bmhcbmnbenmcecpmpepghooflbehcack_3_3_5	#liner-modal-progressbar	#liner-modal-save-label	#liner-modal-container	.normalFont	.linerNoSelect	#liner-modal-save-btn	#liner-modal-close-btn
bmndhenalpjnldpihlofieooecbloldn_1_1_1	.vks
cepbmjgbpkdbkfpocefnpcajdbhnbppn_1_0_4	.xx_blk_inj	#cto_iframe__rand	#AdFox_banner__rand	#adfox-direct_rand	.mgbox	#ad_creative_rand	#google_ads_iframe_rand	#adfoxHtml5_iframe__rand	#_rand	#begun_block_rand	.bn_	#AdFox_plug__rand	.xx_blk	#AdFox_iframe__rand
ckecdkhdccmhijackbigkeddkcnljknd_1_8_9	.vks	.audio_pl_snippet	.audio_pl_snippet__action_btn	.ui_tabs_header	.action_btn_save
dccmnjciogmmahaogjgkocongokmieog_0_5_1	.vks
dipegmpcgkdhknmnhjjfnfmhhpdkigeb_2_0_3	.vks
doocmbmlcnbbdohogchldhlikjpndpng_1_8	.block	.yts-replay-button-medium	.centered	.yts-replay-button-short	.flip-along-vertical-line	.seek-duration	.yts-replay-button	.ytp-button
elflbehbhjfjgfkabalcojanmmdkhhek_2_0_3	.vks
eodccemmopepiegcokmpfmbjponimpbd_1_0_6	.vks
hadcfiekcaagaenlojddigpocfpambep_2_0_5	.vks
heidbfcbfdcinibnlglfpbjdokofnkje_1_6_2	.vks
jgfgdgkipplhaiggoplpallikmheichc_1_0_11	.btn-default	.active	#all_media_files	#downloaded_media_files	.btn	.progress-bar	.progress-striped	#my_progress_bar	#progress_bar_donload_media	.progress
jlhoacblbnkifbpdkepeodekkdkodlie_1_0_3	.vks
kikfnibgegiogngdffdibdhkhgjkfglj_1_0_4	.vks
knekbkhffeelkbilpcdpgbdpeandanfj_0_1_0_113	._322_notRecording
lkjejgoogbgnhfdoglcghhmhakknigig_1_6_1	.vks
lmlnplkfbiihcpkghkkmfefjdaccmbcc_0_1_3	.vks
mbdlohidfkalinabhlcgkpfolmmbnoec_2_1	.vkt-height-fix
njeebhjilmmcmiikhknfpidmgeohkadh_2_0_0_0	.show
oadohiloeinlhonemkjlnoiiibjgipeb_16_6226_217	.____s11f4gg3362j	.xx_blk_inj	#cto_iframe__rand	#AdFox_banner__rand	#adfox-direct_rand	.mgbox	#ad_creative_rand	#google_ads_iframe_rand	#adfoxHtml5_iframe__rand	#_rand	#begun_block_rand	.bn_	#AdFox_plug__rand	.xx_blk	#AdFox_iframe__rand
ojoeblnpmednmebhklpdghncobbjiooi_1_0_17	.firegram-exclude-element
okbpfbebponpmlbjffjcagceiehnkekb_1_0_11	.tym-clipit-button-small-rollover-top
pbadmelojclloofgofgflmjdkfdpfddo_1_0_2	.vks
